SEQ	Mutations
AATCAACTCCAGCAGCGCGGCCTCGTCGT	A1A
TCGTCGTTGGCCACCCGCTGCGAGAGCAAT	T1T
TGCAGTAATGGTCGGCCTTACCGGCGTCCA	T1T
ACTCGACCGCTAATTGAGAGATGCGATTG	A1A
ATCAGCGCGGCACGGCTCTTGTTGTAGTCG	A1A
GCGTTCCAGCGCCGAAAGTATTCCAGCAG	G1G
AGCAGCTGGGCGCGCATTCGGTTCGATCG	A1A
CGGGTAGTTACCGCGGCGAAGGCAAGAC	C1C
AACCGACGACATCGACCACTTCGGCAACCG	A1A
CCAGCGCCGACAGTCGGCGCTTGTGGGTCAA	C1C
ACGTCCATTCATTCCCTCCTTGACGAGGGG	A1A
CGAACATCCCAGTGACGTTGCCTTCGGTCG	C1C
TAAATGTGTTTTATCTGATGCAAGAGGGGGAG	T1T
GATTTACTAAACTTTTTGATATACTCCCTGAATC	G1G
ATGGGCCAAAAACCCAAACTTTTCTGGTCCTC	A1A
CTCCACCCGACCCTATTTTACACCAACCCCCAGT	C1C
GCGTTCTGCGAAAACCGAAAAATGGGTGCAGA	G1G
CAAACTTTTCTGGTCCTCCGGGTAGGGGCGT	C1C
ATGGGCCAAAAACCCAAACTTTTCTGGTCCTC	A1A
CTGGTCCTCCGGGTAGGGGCGTTCTGCGA	C1C
TCTGCGAAAACCGAAAAATGGGTGCAGA	T1T
ACTTTTCTGGTCCTCCGGGTAGGGGCGT	A1A
ATGGGCCAAAAACCCAAACTTTTCTG	A1A
ATGGGCCAAAAACCCAAACTTTTCTGGTCCTCCG	A1A
TGTAAAATAGGGTCGGGTGGAGGGGAAATTCG	T1T
TCGGACGTGTGTGGATATGGCCTGGGTGGGGACT	T1T
ACTGGGGGTTGGTGTAAAATAGGGTCGGGTGGAG	A1A
CGGGGCGGGAAACTGGGGGTTGGTGTAAAATAG	C1C
GAGGGGAAATTCGGGGCTCGGACGTGTGTGGATA	G1G
GTCGGGTGGAGGGGAAATTCGGGGCTCG	G1G
GTTGGTGTAAAATAGGGTCGGGTGGAG	G1G
ACTGGGGGTTGGTGTAAAATAGGGTCG	A1A
GTTGGTGTAAAATAGGGTCGGGTG	G1G
TTTTGCATTCTTTTTAAGTCTAATTTTAACAGCTT	T1T
GTTAAGTCTTAGGGCATGGAAAGTATCTAAAATTC	G1G
GTTTGAAAAATTTGATAGTGATTATGTTTTTGGAT	G1G
CAATAACTTCAATGCTATAACTATCCGAAGAAG	C1C
GATAAACACAGGAAACAGCTATGACCATGATTACG	G1G
AGGATTCATTTTCGCAGTACACCAGGAGTT	A1A
CAACCTATGCAAACACATTAGCGTCTCTT	C1C
CCTCCCTCCTATCTTTCAGCCAACCCAGCA	C1C
CTATATACAGAAAATTAAGCGACCAACCTTG	C1C
CTTCTGCCTTTGTTCTTTTAGCCTCAATAG	C1C
ATTAAGCGACCAACCTTGTCCTGATGACAC	A1A
TCCCGGACAGGCCGAGTTTGGTCATCAGCCGTTC	T1T
GCCGCGTCCACGCCGCCAACTACGGTGTTTACGG	G1G
CGGAGCCGTCCTCGCCGAACAACACGACGAATGG	C1C
GGTCAGTGCTGGGGTGTTGGTGGTTTGCTGCTT	G1G
CCGTTCTCATGATTTCCATGGTCCAGGGTT	C1C
CCTGAACACCTCATGTCGTGGTAGAAATAG	C1C
CCTTCATTATGTCGGAGTCTGAGCACCCTAGGC	C1C
CTCTCAAGCAGGACTACAAGCTGCAATCCCTT	C1C
AAGTCAGGTGGAGCGAGGCTAGCTGGCCCGATT	A1A
CACCATGCCACAGCCACCACACCTCTGCGGGGA	C1C
TTTCACCAGCTGTATTAGAAGTACATGCTGATC	T1T
ACTGTCTCAGGGTTGGCACGCAATGAAGTC	A1A
AGAGGTCGCACTTCATTTAGGCGACGATACT	A1A
ACGGAGCTTGTCTGTGAATCGGATCTTTCTC	A1A
GTGGCAATGACGGGTAACGGGGAATTAGGG	G1G
AATTGATACTTGTAAAGGGGTTTATACTTAACTC	A1A
AAATCCTGTGTGCTAATTGAGGTGCATTGG	A1A
AAATCCTGTGTGCTAATTGAGGTGTATTGG	A1A
GATCCTGCGAGCGTAGGCGTCGGTGACAAAGGCCACGTAG	G1G
CTGATCCGGCCACAGCCCGTCCCGCCGATCTCGTCCAGC	C1C
CAGTAGTGGGCGGTCATCGCGTGATCCTTCGAAACGACC	C1C
CTCGCCTGTGCGAGTTGGTCAGCCAGAAGCTG	C1C
TACGCTCACCCAGACGATGGACAAGCCCG	T1T
TGTGCGATGGCGTCCTTGATCATCTTCACGC	T1T
TGTGCGATGGCGTCCTTGATCATCTTCACGC	T1T
ACCACCCGCGGCAAAGCCCGCAGGACCACGAT	A1A
TAGGCGAACCCTGCCCAGGTCGACACATAGGTGA	T1T
CACAGAGCGCCGCAAGATGGATTGGTGTTGTTGAT	C1C
AGATGGATTGGTGTTGTTGATCCAACAGG	A1A
TCAATCCAGGCACAGAGCGCCGCAAGATG	T1T
AACAGCATATTGACGCTGGGAAAGACCAGAGATC	A1A
CACAAAAACAGCATATTGACGCTGGGAAAG	C1C
TAAAGTTGCATGATGGTTCAGAACTCATAGCA	T1T
TATTGCAATAACCTGATCTCCTACTCTAGA	T1T
TATTGCAATAACCTGATCTCCTACTCTAGA	T1T
CTAGAACTAACATCACAAAGAGCTTTAGAATC	C1C
CAATATTGACCTGTACTGTTCCTATAAGTTT	C1C
CAATATTGACCTGTACTGTTCCTATAAGTTT	C1C
TTGTGAACATACCCCCAAAACCGTTGCTTCGGC	T1T
GTAGTGTAGTGTCCCTCGGCCCCCTCCGC	G1G
ATTATACAACACCCTATTTGCTCTGTACGG	A1A
CCGTACAGAGCAAATAGGGTGTTGTATAAT	C1C
GCAGCACGCCCTGGGCGAGTTGGATATAA	G1G
AAATGAGTTGGGCTTTAACGGCCGGAGCCCGCAG	A1A
GACGACAATCCTGGCCATCAAGATGATGATCC	G1G
GACTTGGTCCTATTCGATCTAGACGAGGACG	G1G
TGATCCAACTGACTCACAGGATACGACCATTC	T1T
TGATCCGACTGACTCACAGGATACGACCATTC	T1T
TGCACCAGATGACTTGATCCTATTCGATCTAGA	T1T
TGCACCAGATGACTTGGTCCTATTCGATCTAGA	T1T
TGCACCAGATGATTTGATCCTATTCGATCTAGA	T1T
TGCACCAGATGATTTGGTCCTATTCGATCTAGA	T1T
CTAGTAAGCTGTTCGAGATCACCTTGTTCATCATG	C1C
TTCCGACGGACGTATGAATATGTCCATGGTGAACG	T1T
CGTATGAATATGTCCATGGTGAACGATGTACCAAC	C1C
AGCGTTCATTCAATTCATGTCTGAGGTAAACGGCA	A1A